(3)
{1,1,0,0}
{1,2,0,1}
{2,3,0,2}
{2,4,1,0}
{3,5,1,1}
{3,6,1,2}
{4,7,2,0}
{4,8,2,1}
{4,9,2,2}